#########O###################################################################################################################
#                                                                                                                           #
########## ################       #                         #         ##################################################### #
#          #                      #     #       #           #         #                                           #       # #
########## # #################### #                         #         #    #             #    #   #  #  #    #   #    #   # #
#          #                      #      #     #   #        #         #       #                  #       #    #      #    # #
########## ############## #########       #    #            #         #                 #                  #              # #
#          #                      #    #   #                #         #                       #     #                     # #
# ##########  #     #   #         #             #           #         #                #                #      #          # #
#          #     #                #  #        #  #  #       #         #       #    #           #                          # #
########## #              #   #   #      #  #               #         #                      #    #   #  #                # #
#          #   #    #             #          #  #           #         #          #                 #             #        # #
# ##########                 #    #   #   #    #            #         #         #   #                                     # #
#          #       #     #        #                #        #         #      #              #   #       #   #             # #
########## ########################       #                 #         #     #    #                              #         # #
#          #   #               #  #    #       #            #         #                            #               #      # #
# ##########  #    #     # #      #         #    #   # #    #         #            #      #       #    #   #   #          # #
#          #       #     #    #   #    #                    #         #    #     #      #                            #    # #
########## #       #         #    #              #  #       #         #                           #          #  #         # #
#          #  #                   #      #   #      #       #         #     #      #                    #          #      # #
############      #############   #       #      #    #     #         #      #       #   # #   #           #     #        # #
#          #                      #                         #         #        #                   #          # #   #     # #
#                  #        #                #          #              #              #  #  #  #      #    #    #  #      # #
# ##########################################   #           #  #         #                #       #                     ### #
#                                               #  #             #         #                                            #   #
# ####################################################################################################################### ###
#                                                                                                                           #
###########################################################################################################################O#