#######O######################
#     #                 #    #
# ### ################# #  # #
#   # #                 #  # #
### # # #################  # #
#   # #   #          #     # #
# ### # # # ##  ########## # #
#   #       #              # #
### ######################## #
#                       #    #
#######################O######